,date,fremont_bridge_nb,fremont_bridge_sb,hour,count
37,2015-07-30,20,22,5,42
38,2015-07-11,29,36,20,65
39,2015-07-31,88,103,19,191
40,2015-07-14,448,190,8,638
41,2015-07-17,32,66,20,98
42,2015-07-31,25,16,5,41
43,2015-07-31,166,93,9,259
44,2015-07-05,44,26,7,70
45,2015-07-06,49,57,12,106
46,2015-07-21,168,302,18,470
49,2015-07-05,15,16,22,31
50,2015-07-15,44,53,13,97
51,2015-07-06,118,163,16,281
52,2015-07-22,383,210,8,593
53,2015-07-01,33,19,5,52
54,2015-07-11,2,6,3,8
55,2015-07-04,77,65,10,142
56,2015-07-12,97,72,13,169
57,2015-07-15,149,206,16,355
58,2015-07-07,403,204,8,607
59,2015-07-03,68,72,18,140
60,2015-07-16,41,50,12,91
61,2015-07-26,55,49,10,104
62,2015-07-06,5,2,2,7
63,2015-07-31,11,13,0,24
64,2015-07-28,122,232,16,354
65,2015-07-15,397,220,8,617
66,2015-07-30,43,39,12,82
67,2015-07-16,26,13,5,39
68,2015-07-15,147,53,6,200
69,2015-07-12,8,9,1,17
70,2015-07-04,83,82,15,165
72,2015-07-29,8,2,4,10
73,2015-07-03,79,67,17,146
74,2015-07-23,6,7,4,13
75,2015-07-17,47,46,11,93
76,2015-07-10,249,108,7,357
77,2015-07-12,45,21,8,66
79,2015-07-21,366,189,8,555
80,2015-07-17,2,0,2,2
81,2015-07-21,110,144,19,254
82,2015-07-14,233,527,17,760
83,2015-07-16,136,241,16,377
85,2015-07-26,58,44,16,102
86,2015-07-16,30,27,22,57
87,2015-07-14,0,73,10,73
88,2015-07-18,107,79,12,186
89,2015-07-01,114,168,19,282
90,2015-07-08,13,15,23,28
91,2015-07-03,3,3,3,6
92,2015-07-08,71,77,15,148
93,2015-07-07,364,138,7,502
94,2015-07-02,2,5,2,7
96,2015-07-25,11,16,21,27
97,2015-07-27,51,38,12,89
98,2015-07-31,32,41,22,73
99,2015-07-30,5,5,1,10
100,2015-07-24,40,49,13,89
101,2015-07-04,23,16,6,39
102,2015-07-21,1,2,2,3
103,2015-07-30,59,51,11,110
104,2015-07-24,7,15,0,22
105,2015-07-06,158,327,18,485
106,2015-07-04,48,43,22,91
107,2015-07-31,171,362,17,533
108,2015-07-16,190,515,17,705
109,2015-07-02,15,18,23,33
110,2015-07-03,49,58,19,107
111,2015-07-16,51,60,14,111
112,2015-07-16,394,177,8,571
113,2015-07-27,61,45,10,106
114,2015-07-30,8,10,0,18
115,2015-07-15,6,6,4,12
116,2015-07-17,248,104,7,352
118,2015-07-16,107,148,19,255
119,2015-07-15,35,34,22,69
120,2015-07-20,57,87,15,144
121,2015-07-25,34,13,7,47
122,2015-07-11,11,19,23,30
123,2015-07-17,60,57,13,117
124,2015-07-04,37,36,7,73
125,2015-07-25,11,15,23,26
126,2015-07-29,392,231,8,623
127,2015-07-31,132,218,16,350
128,2015-07-07,113,66,6,179
129,2015-07-09,13,13,0,26
130,2015-07-22,143,269,16,412
131,2015-07-17,83,58,10,141
132,2015-07-16,7,4,4,11
133,2015-07-13,284,114,7,398
134,2015-07-25,64,67,12,131
135,2015-07-31,95,44,6,139
136,2015-07-07,68,59,14,127
137,2015-07-26,47,35,9,82
138,2015-07-28,139,167,19,306
139,2015-07-10,32,27,21,59
140,2015-07-29,70,47,14,117
142,2015-07-17,113,230,18,343
143,2015-07-28,392,224,8,616
144,2015-07-17,157,122,9,279
145,2015-07-23,69,77,20,146
146,2015-07-31,54,53,12,107
147,2015-07-14,160,132,9,292
148,2015-07-25,25,23,8,48
149,2015-07-14,25,31,22,56
150,2015-07-05,92,65,15,157
151,2015-07-03,12,24,0,36
152,2015-07-12,8,15,22,23
153,2015-07-24,127,97,9,224
154,2015-07-29,2,3,1,5
155,2015-07-07,194,526,17,720
156,2015-07-24,29,35,21,64
157,2015-07-13,171,347,18,518
158,2015-07-09,51,62,14,113
159,2015-07-20,39,49,12,88
160,2015-07-14,5,4,1,9
161,2015-07-28,335,145,7,480
162,2015-07-11,62,64,10,126
163,2015-07-28,74,66,10,140
164,2015-07-30,55,46,13,101
167,2015-07-16,71,49,10,120
168,2015-07-31,244,119,7,363
169,2015-07-06,71,84,20,155
170,2015-07-12,12,11,23,23
171,2015-07-22,43,51,13,94
172,2015-07-16,13,32,23,45
173,2015-07-04,91,103,12,194
174,2015-07-31,5,10,1,15
175,2015-07-30,22,23,23,45
176,2015-07-09,3,2,2,5
177,2015-07-31,49,69,14,118
178,2015-07-22,22,23,22,45
179,2015-07-09,51,48,21,99
180,2015-07-24,295,146,8,441
181,2015-07-23,24,14,5,38
182,2015-07-23,179,291,18,470
183,2015-07-02,380,170,8,550
184,2015-07-04,74,75,9,149
185,2015-07-10,103,85,15,188
186,2015-07-27,52,64,14,116
187,2015-07-21,3,9,1,12
188,2015-07-28,123,60,6,183
189,2015-07-01,4,7,3,11
190,2015-07-12,30,22,21,52
191,2015-07-11,16,34,22,50
192,2015-07-06,46,42,21,88
193,2015-07-24,4,4,1,8
194,2015-07-21,168,487,17,655
195,2015-07-17,7,6,1,13
196,2015-07-02,75,116,15,191
197,2015-07-28,8,3,4,11
198,2015-07-19,91,69,14,160
199,2015-07-16,5,4,2,9
200,2015-07-13,0,5,2,5
201,2015-07-21,14,15,23,29
203,2015-07-26,5,10,23,15
204,2015-07-26,23,22,8,45
205,2015-07-08,5,3,4,8
206,2015-07-24,95,185,18,280
207,2015-07-09,334,138,7,472
208,2015-07-18,13,21,23,34
209,2015-07-15,5,5,1,10
210,2015-07-30,72,70,15,142
211,2015-07-18,83,77,16,160
213,2015-07-30,127,204,16,331
215,2015-07-01,371,148,7,519
216,2015-07-08,58,48,11,106
218,2015-07-11,39,36,19,75
219,2015-07-10,12,27,23,39
220,2015-07-10,154,106,9,260
221,2015-07-27,52,43,13,95
222,2015-07-01,60,42,11,102
223,2015-07-23,10,12,0,22
224,2015-07-19,28,24,7,52
225,2015-07-10,2,6,2,8
226,2015-07-26,24,19,19,43
227,2015-07-19,81,65,9,146
228,2015-07-19,3,1,4,4
229,2015-07-07,148,209,16,357
230,2015-07-27,56,76,20,132
231,2015-07-19,94,90,13,184
233,2015-07-05,5,8,2,13
234,2015-07-18,3,5,3,8
235,2015-07-27,0,4,1,4
236,2015-07-09,20,32,5,52
237,2015-07-16,49,58,21,107
238,2015-07-27,351,169,8,520
239,2015-07-29,31,16,5,47
240,2015-07-03,25,24,21,49
241,2015-07-26,12,13,6,25
242,2015-07-10,5,8,1,13
243,2015-07-12,46,41,9,87
244,2015-07-21,118,53,6,171
245,2015-07-20,159,118,9,277
246,2015-07-09,78,40,10,118
247,2015-07-02,49,63,20,112
248,2015-07-15,354,154,7,508
249,2015-07-14,3,1,3,4
250,2015-07-18,9,12,0,21
251,2015-07-29,5,6,0,11
252,2015-07-24,126,378,17,504
253,2015-07-18,5,5,2,10
254,2015-07-02,27,26,5,53
255,2015-07-01,23,23,23,46
256,2015-07-04,64,88,16,152
257,2015-07-14,160,228,16,388
258,2015-07-18,21,34,7,55
259,2015-07-24,56,62,20,118
260,2015-07-06,98,120,19,218
261,2015-07-25,68,47,13,115
262,2015-07-28,2,1,2,3
264,2015-07-07,106,157,19,263
266,2015-07-13,42,54,21,96
267,2015-07-14,23,63,11,86
268,2015-07-21,45,53,10,98
269,2015-07-01,83,50,10,133
270,2015-07-28,39,50,21,89
271,2015-07-20,24,18,5,42
272,2015-07-30,0,3,3,3
273,2015-07-09,140,51,6,191
274,2015-07-19,1,4,2,5
275,2015-07-27,296,129,7,425
276,2015-07-04,84,70,13,154
277,2015-07-24,76,246,22,322
278,2015-07-07,48,46,21,94
279,2015-07-11,68,63,14,131
280,2015-07-06,9,10,23,19
281,2015-07-13,62,92,20,154
282,2015-07-03,23,21,6,44
283,2015-07-15,104,165,19,269
284,2015-07-11,7,6,1,13
285,2015-07-03,74,64,8,138
286,2015-07-22,7,6,0,13
287,2015-07-09,58,41,12,99
289,2015-07-25,11,4,1,15
290,2015-07-14,121,186,19,307
291,2015-07-17,27,13,5,40
292,2015-07-05,95,68,11,163
293,2015-07-13,50,42,10,92
294,2015-07-08,55,60,21,115
295,2015-07-07,197,301,18,498
296,2015-07-05,67,52,18,119
297,2015-07-07,4,5,4,9
298,2015-07-03,59,74,14,133
299,2015-07-24,76,49,6,125
300,2015-07-15,31,50,21,81
301,2015-07-20,302,121,7,423
302,2015-07-30,184,458,17,642
303,2015-07-19,44,50,18,94
304,2015-07-19,26,23,21,49
305,2015-07-02,159,365,17,524
306,2015-07-09,376,217,8,593
307,2015-07-03,113,85,13,198
308,2015-07-27,11,22,22,33
309,2015-07-08,132,174,19,306
310,2015-07-26,12,19,20,31
311,2015-07-16,310,119,7,429
312,2015-07-27,35,46,21,81
313,2015-07-30,165,311,18,476
314,2015-07-18,52,50,8,102
315,2015-07-18,67,68,11,135
316,2015-07-08,201,326,18,527
317,2015-07-01,5,4,1,9
318,2015-07-17,106,49,6,155
319,2015-07-20,74,51,10,125
320,2015-07-04,3,2,3,5
321,2015-07-02,135,221,16,356
322,2015-07-13,47,51,11,98
323,2015-07-02,34,39,22,73
324,2015-07-17,13,13,0,26
325,2015-07-17,5,4,4,9
326,2015-07-21,123,212,16,335
327,2015-07-21,43,57,21,100
328,2015-07-12,59,45,10,104
329,2015-07-15,3,5,0,8
330,2015-07-18,44,44,19,88
331,2015-07-17,75,98,19,173
332,2015-07-25,13,10,6,23
333,2015-07-03,2,4,2,6
334,2015-07-02,55,52,21,107
335,2015-07-11,37,27,21,64
336,2015-07-27,2,1,2,3
337,2015-07-22,19,16,5,35
338,2015-07-01,48,61,21,109
339,2015-07-03,87,66,10,153
340,2015-07-14,7,4,4,11
341,2015-07-06,4,2,3,6
342,2015-07-11,13,54,5,67
343,2015-07-09,75,78,15,153
344,2015-07-20,1,8,0,9
345,2015-07-05,80,54,12,134
346,2015-07-19,112,80,11,192
347,2015-07-23,0,3,2,3
348,2015-07-09,112,168,19,280
349,2015-07-02,50,39,11,89
350,2015-07-03,17,23,23,40
351,2015-07-08,3,1,3,4
352,2015-07-21,174,123,9,297
354,2015-07-09,2,8,4,10
355,2015-07-27,4,0,3,4
356,2015-07-20,23,16,22,39
358,2015-07-18,67,70,17,137
359,2015-07-06,288,116,7,404
360,2015-07-01,9,4,4,13
361,2015-07-28,72,109,15,181
362,2015-07-16,42,69,13,111
363,2015-07-16,88,85,20,173
364,2015-07-14,73,115,20,188
365,2015-07-05,51,52,9,103
366,2015-07-19,9,6,5,15
367,2015-07-19,10,16,23,26
368,2015-07-20,103,59,6,162
369,2015-07-05,0,1,3,1
370,2015-07-11,66,69,11,135
371,2015-07-12,108,104,14,212
372,2015-07-04,74,101,23,175
373,2015-07-23,52,59,11,111
374,2015-07-20,52,51,13,103
375,2015-07-27,22,13,5,35
376,2015-07-04,87,71,14,158
377,2015-07-18,1,8,1,9
378,2015-07-11,62,41,18,103
379,2015-07-08,10,5,1,15
380,2015-07-05,48,39,17,87
381,2015-07-01,163,329,18,492
382,2015-07-06,180,471,17,651
383,2015-07-12,4,10,2,14
384,2015-07-08,373,210,8,583
385,2015-07-09,2,3,3,5
386,2015-07-17,47,52,12,99
388,2015-07-04,12,10,0,22
389,2015-07-07,69,96,15,165
390,2015-07-21,60,41,13,101
391,2015-07-23,61,61,13,122
392,2015-07-12,91,84,12,175
393,2015-07-15,175,113,9,288
394,2015-07-27,52,36,11,88
395,2015-07-31,115,207,18,322
397,2015-07-07,52,55,13,107
398,2015-07-02,129,232,18,361
399,2015-07-22,48,62,11,110
400,2015-07-06,60,62,14,122
401,2015-07-04,75,61,8,136
402,2015-07-26,20,18,7,38
403,2015-07-30,120,158,19,278
404,2015-07-10,89,50,6,139
405,2015-07-25,3,6,5,9
406,2015-07-25,12,15,22,27
407,2015-07-04,3,0,4,3
408,2015-07-25,9,1,2,10
409,2015-07-22,1,0,3,1
411,2015-07-23,117,58,6,175
412,2015-07-12,14,11,0,25
413,2015-07-01,212,508,17,720
414,2015-07-20,3,2,3,5
415,2015-07-02,71,108,19,179
416,2015-07-04,52,62,19,114
417,2015-07-15,9,22,23,31
418,2015-07-12,2,5,4,7
419,2015-07-15,72,104,20,176
420,2015-07-02,47,48,13,95
421,2015-07-06,47,54,13,101
423,2015-07-12,49,45,19,94
424,2015-07-29,36,36,22,72
425,2015-07-06,58,52,10,110
426,2015-07-30,271,145,7,416
427,2015-07-13,102,55,6,157
428,2015-07-26,35,46,18,81
429,2015-07-14,56,57,21,113
431,2015-07-26,109,63,14,172
433,2015-07-28,45,54,12,99
434,2015-07-13,5,1,4,6
435,2015-07-31,62,62,10,124
436,2015-07-18,1,10,4,11
437,2015-07-06,4,3,1,7
438,2015-07-13,139,106,9,245
439,2015-07-24,68,94,15,162
441,2015-07-02,75,51,10,126
442,2015-07-28,31,44,22,75
443,2015-07-09,129,221,16,350
444,2015-07-28,184,122,9,306
445,2015-07-20,383,180,8,563
446,2015-07-30,107,59,6,166
447,2015-07-14,20,14,23,34
448,2015-07-25,31,31,20,62
449,2015-07-29,2,1,3,3
450,2015-07-13,4,7,0,11
451,2015-07-25,29,25,9,54
452,2015-07-16,172,103,9,275
453,2015-07-06,368,167,8,535
454,2015-07-23,44,56,12,100
455,2015-07-23,95,103,15,198
456,2015-07-31,4,5,4,9
457,2015-07-15,48,75,14,123
458,2015-07-18,89,87,14,176
459,2015-07-24,1,2,3,3
460,2015-07-05,82,71,13,153
461,2015-07-20,6,3,4,9
462,2015-07-24,66,43,10,109
463,2015-07-18,12,17,6,29
464,2015-07-01,2,7,2,9
465,2015-07-31,2,0,3,2
466,2015-07-22,189,138,9,327
467,2015-07-28,6,7,0,13
468,2015-07-26,71,76,11,147
469,2015-07-20,93,163,19,256
470,2015-07-05,64,69,10,133
471,2015-07-07,3,4,3,7
472,2015-07-03,40,44,20,84
473,2015-07-15,27,23,5,50
474,2015-07-01,57,48,13,105
475,2015-07-13,35,25,22,60
476,2015-07-03,35,34,22,69
477,2015-07-13,182,452,17,634
478,2015-07-12,6,7,6,13
480,2015-07-19,8,22,0,30
481,2015-07-11,15,36,4,51
482,2015-07-22,38,60,21,98
483,2015-07-29,1,4,2,5
484,2015-07-25,54,34,18,88
485,2015-07-11,81,63,17,144
486,2015-07-19,80,60,15,140
487,2015-07-15,4,2,3,6
488,2015-07-29,76,76,15,152
489,2015-07-27,4,6,0,10
490,2015-07-21,4,5,4,9
491,2015-07-29,96,181,19,277
492,2015-07-22,81,111,15,192
493,2015-07-19,6,0,3,6
494,2015-07-21,1,4,3,5
495,2015-07-16,11,8,0,19
496,2015-07-02,5,4,1,9
497,2015-07-09,173,306,18,479
498,2015-07-02,2,3,3,5
499,2015-07-01,7,7,0,14
500,2015-07-01,75,85,15,160
501,2015-07-03,77,56,15,133
502,2015-07-17,322,148,8,470
503,2015-07-13,32,11,5,43
504,2015-07-08,71,51,12,122
505,2015-07-26,2,1,4,3
506,2015-07-16,59,85,15,144
508,2015-07-12,33,36,20,69
510,2015-07-11,84,66,13,150
511,2015-07-27,143,327,18,470
512,2015-07-20,40,37,11,77
513,2015-07-24,1,2,2,3
514,2015-07-08,9,11,0,20
515,2015-07-31,315,189,8,504
516,2015-07-30,72,58,10,130
517,2015-07-15,63,66,10,129
519,2015-07-26,28,26,17,54
520,2015-07-10,50,45,12,95
521,2015-07-11,77,41,9,118
522,2015-07-23,143,194,16,337
523,2015-07-07,9,10,0,19
524,2015-07-26,4,5,5,9
528,2015-07-05,12,10,6,22
529,2015-07-05,52,55,19,107
530,2015-07-07,64,64,12,128
531,2015-07-29,63,52,11,115
532,2015-07-14,390,146,7,536
533,2015-07-07,33,24,5,57
535,2015-07-05,8,8,23,16
536,2015-07-26,11,6,21,17
537,2015-07-17,17,27,23,44
538,2015-07-23,99,149,19,248
539,2015-07-20,4,3,2,7
540,2015-07-11,7,6,2,13
541,2015-07-17,145,231,16,376
542,2015-07-13,56,43,14,99
543,2015-07-22,62,95,14,157
544,2015-07-11,22,34,6,56
545,2015-07-23,27,20,22,47
546,2015-07-11,90,70,12,160
547,2015-07-03,89,68,9,157
548,2015-07-26,5,5,2,10
550,2015-07-14,146,63,6,209
551,2015-07-10,6,5,0,11
552,2015-07-16,147,299,18,446
553,2015-07-07,92,60,10,152
554,2015-07-07,55,55,11,110
555,2015-07-08,32,18,5,50
556,2015-07-08,73,46,13,119
558,2015-07-25,35,35,11,70
559,2015-07-27,93,126,19,219
560,2015-07-23,290,139,7,429
561,2015-07-21,71,90,15,161
562,2015-07-28,219,517,17,736
563,2015-07-08,64,49,14,113
564,2015-07-29,48,54,12,102
565,2015-07-10,43,40,20,83
566,2015-07-27,155,109,9,264
567,2015-07-19,52,52,17,104
568,2015-07-06,54,84,15,138
569,2015-07-22,126,170,19,296
570,2015-07-01,56,59,12,115
571,2015-07-28,50,43,11,93
572,2015-07-09,3,3,1,6
573,2015-07-13,1,4,3,5
574,2015-07-03,55,35,7,90
576,2015-07-05,15,15,1,30
577,2015-07-28,13,22,23,35
578,2015-07-23,362,186,8,548
579,2015-07-26,78,43,13,121
580,2015-07-22,2,1,2,3
581,2015-07-05,5,5,5,10
582,2015-07-14,3,13,0,16
583,2015-07-21,42,44,12,86
584,2015-07-03,11,8,5,19
585,2015-07-10,154,382,17,536
586,2015-07-07,3,2,1,5
587,2015-07-02,5,9,0,14
589,2015-07-08,83,59,10,142
590,2015-07-31,43,87,20,130
591,2015-07-07,8,2,2,10
592,2015-07-16,5,9,1,14
593,2015-07-25,8,15,0,23
594,2015-07-28,57,65,13,122
595,2015-07-17,28,28,22,56
596,2015-07-28,3,5,3,8
597,2015-07-05,66,68,14,134
600,2015-07-15,64,47,11,111
601,2015-07-22,2,4,1,6
602,2015-07-21,23,18,22,41
603,2015-07-06,22,12,5,34
604,2015-07-01,160,101,9,261
605,2015-07-18,36,41,21,77
606,2015-07-12,116,76,15,192
607,2015-07-06,8,8,0,16
608,2015-07-29,15,30,23,45
609,2015-07-20,43,39,21,82
610,2015-07-03,100,86,12,186
611,2015-07-10,24,23,22,47
612,2015-07-10,59,73,14,132
613,2015-07-22,10,23,23,33
614,2015-07-12,21,16,7,37
615,2015-07-14,62,57,14,119
616,2015-07-31,38,22,23,60
617,2015-07-18,94,99,13,193
618,2015-07-08,143,256,16,399
620,2015-07-28,3,7,1,10
621,2015-07-24,6,5,4,11
622,2015-07-29,64,98,20,162
623,2015-07-24,29,28,11,57
624,2015-07-29,127,70,6,197
625,2015-07-15,220,553,17,773
626,2015-07-14,28,17,5,45
627,2015-07-25,54,56,17,110
628,2015-07-02,59,45,12,104
629,2015-07-29,338,144,7,482
630,2015-07-20,161,336,18,497
631,2015-07-27,17,15,23,32
632,2015-07-23,218,469,17,687
633,2015-07-21,38,23,5,61
634,2015-07-31,1,6,2,7
635,2015-07-04,71,61,21,132
636,2015-07-14,172,340,18,512
637,2015-07-10,119,221,18,340
638,2015-07-08,145,52,6,197
639,2015-07-24,56,58,14,114
640,2015-07-30,46,65,14,111
642,2015-07-21,44,54,14,98
643,2015-07-29,58,62,13,120
644,2015-07-18,104,84,15,188
645,2015-07-10,32,17,5,49
646,2015-07-29,183,348,18,531
647,2015-07-23,167,120,9,287
648,2015-07-31,84,98,15,182
649,2015-07-27,98,45,6,143
650,2015-07-25,51,60,16,111
651,2015-07-01,76,99,20,175
652,2015-07-29,69,74,10,143
653,2015-07-04,4,10,1,14
654,2015-07-03,104,72,11,176
655,2015-07-08,334,153,7,487
656,2015-07-03,4,3,4,7
657,2015-07-28,31,19,5,50
658,2015-07-04,7,5,5,12
659,2015-07-23,2,4,1,6
660,2015-07-21,46,48,11,94
661,2015-07-23,43,73,14,116
662,2015-07-18,34,22,22,56
663,2015-07-16,5,2,3,7
664,2015-07-29,191,113,9,304
665,2015-07-13,49,41,12,90
666,2015-07-12,79,79,11,158
667,2015-07-27,122,227,16,349
668,2015-07-25,39,40,19,79
669,2015-07-04,79,56,11,135
670,2015-07-10,72,49,10,121
671,2015-07-14,85,82,15,167
672,2015-07-30,5,5,4,10
673,2015-07-25,68,56,15,124
674,2015-07-27,74,101,15,175
675,2015-07-11,12,15,0,27
676,2015-07-12,5,4,5,9
677,2015-07-13,73,99,15,172
678,2015-07-19,12,25,22,37
679,2015-07-31,45,64,21,109
680,2015-07-15,170,336,18,506
681,2015-07-13,136,198,16,334
682,2015-07-05,57,80,16,137
683,2015-07-18,5,5,5,10
684,2015-07-13,10,8,23,18
685,2015-07-17,30,37,21,67
686,2015-07-09,17,22,23,39
687,2015-07-18,35,40,20,75
688,2015-07-02,53,76,14,129
689,2015-07-20,8,19,23,27
690,2015-07-07,67,87,20,154
691,2015-07-13,49,41,13,90
692,2015-07-15,2,6,2,8
693,2015-07-18,64,73,18,137
694,2015-07-10,62,58,13,120
695,2015-07-29,143,264,16,407
696,2015-07-07,11,19,23,30
697,2015-07-21,66,58,20,124
698,2015-07-20,68,89,20,157
699,2015-07-05,38,37,8,75
700,2015-07-02,7,3,4,10
701,2015-07-11,50,37,8,87
702,2015-07-09,51,55,11,106
704,2015-07-01,121,215,16,336
705,2015-07-12,102,84,16,186
706,2015-07-30,44,31,22,75
707,2015-07-22,53,55,12,108
708,2015-07-29,196,490,17,686
709,2015-07-18,80,83,10,163
710,2015-07-28,73,72,14,145
711,2015-07-26,2,2,3,4
712,2015-07-19,6,15,6,21
713,2015-07-05,47,26,20,73
714,2015-07-14,55,50,12,105
715,2015-07-27,199,506,17,705
716,2015-07-27,3,1,4,4
717,2015-07-17,172,376,17,548
718,2015-07-20,129,206,16,335
719,2015-07-19,69,67,10,136
720,2015-07-02,111,52,6,163
722,2015-07-04,2,2,2,4
723,2015-07-11,91,56,16,147
724,2015-07-16,64,47,11,111
725,2015-07-10,144,223,16,367
726,2015-07-09,157,102,9,259
727,2015-07-26,6,17,22,23
728,2015-07-04,75,51,18,126
729,2015-07-19,63,54,8,117
730,2015-07-26,6,13,0,19
731,2015-07-28,174,318,18,492
732,2015-07-01,390,201,8,591
733,2015-07-18,81,54,9,135
734,2015-07-01,76,61,14,137
735,2015-07-11,94,74,15,168
736,2015-07-02,152,99,9,251
738,2015-07-15,87,88,15,175
739,2015-07-12,66,59,18,125
740,2015-07-25,0,4,4,4
743,2015-07-14,73,49,13,122
744,2015-07-01,132,69,6,201
745,2015-07-05,31,22,21,53
746,2015-07-19,5,5,1,10
747,2015-07-29,63,55,21,118
748,2015-07-14,1,4,2,5
749,2015-07-23,37,51,21,88
750,2015-07-26,92,77,15,169
751,2015-07-20,3,7,1,10
752,2015-07-17,65,67,14,132
753,2015-07-25,27,25,10,52
754,2015-07-10,66,118,19,184
755,2015-07-05,4,2,4,6
756,2015-07-17,4,7,3,11
757,2015-07-30,5,2,2,7
758,2015-07-22,174,335,18,509
759,2015-07-24,30,30,23,60
760,2015-07-04,60,68,17,128
761,2015-07-19,59,55,16,114
762,2015-07-31,57,47,13,104
765,2015-07-24,127,190,16,317
766,2015-07-23,10,28,23,38
768,2015-07-12,94,83,17,177
769,2015-07-19,74,80,12,154
770,2015-07-13,81,135,19,216
771,2015-07-30,397,208,8,605
772,2015-07-24,22,14,5,36
773,2015-07-09,204,472,17,676
774,2015-07-08,29,36,22,65
775,2015-07-31,67,54,11,121
776,2015-07-07,27,34,22,61
777,2015-07-24,243,99,7,342
778,2015-07-28,79,89,20,168
779,2015-07-20,61,61,14,122
780,2015-07-23,2,1,3,3
781,2015-07-08,218,508,17,726
782,2015-07-07,176,98,9,274
783,2015-07-17,72,97,15,169
784,2015-07-25,3,0,3,3
785,2015-07-06,6,3,4,9
786,2015-07-30,54,64,21,118
787,2015-07-25,71,55,14,126
788,2015-07-24,43,99,19,142
789,2015-07-08,174,108,9,282
791,2015-07-22,117,57,6,174
792,2015-07-10,48,50,11,98
793,2015-07-16,139,58,6,197
794,2015-07-09,62,48,13,110
795,2015-07-22,49,77,20,126
796,2015-07-21,7,10,0,17
797,2015-07-24,41,34,12,75
798,2015-07-01,35,24,22,59
799,2015-07-23,77,50,10,127
800,2015-07-06,20,26,22,46
801,2015-07-12,1,2,3,3
802,2015-07-03,87,90,16,177
803,2015-07-03,10,9,1,19
804,2015-07-22,83,60,10,143
805,2015-07-30,57,99,20,156
806,2015-07-02,273,123,7,396
807,2015-07-09,25,40,22,65
808,2015-07-06,61,38,11,99
809,2015-07-22,213,462,17,675
810,2015-07-06,117,60,6,177
811,2015-07-04,62,58,20,120
812,2015-07-10,2,3,3,5
813,2015-07-22,331,152,7,483
814,2015-07-30,193,112,9,305
815,2015-07-06,148,104,9,252
816,2015-07-11,33,32,7,65
817,2015-07-26,3,6,1,9
818,2015-07-21,367,125,7,492
819,2015-07-13,1,1,1,2
820,2015-07-10,343,166,8,509
821,2015-07-19,46,57,19,103
822,2015-07-10,6,6,4,12
823,2015-07-08,100,91,20,191
824,2015-07-19,38,26,20,64
825,2015-07-09,85,88,20,173
826,2015-07-05,30,62,0,92
827,2015-07-08,7,1,2,8
828,2015-07-13,362,164,8,526
829,2015-07-15,44,40,12,84
830,2015-07-22,9,6,4,15
831,2015-07-26,62,67,12,129
832,2015-07-20,181,473,17,654
838,2015-08-06,18,12,23,30
839,2015-08-18,64,97,20,161
840,2015-08-20,7,2,4,9
841,2015-08-14,23,40,19,63
842,2015-08-19,29,20,5,49
843,2015-08-23,34,37,19,71
844,2015-08-20,57,53,13,110
845,2015-08-22,7,2,5,9
847,2015-08-17,82,49,10,131
848,2015-08-06,52,53,14,105
849,2015-08-15,16,15,7,31
850,2015-08-02,5,15,23,20
851,2015-08-22,2,2,4,4
852,2015-08-20,39,53,14,92
853,2015-08-12,48,54,14,102
854,2015-08-21,4,12,0,16
855,2015-08-27,35,14,5,49
856,2015-08-26,30,19,5,49
857,2015-08-24,42,64,13,106
858,2015-08-29,8,3,21,11
859,2015-08-25,55,54,13,109
860,2015-08-12,5,8,0,13
861,2015-08-03,39,42,12,81
862,2015-08-19,21,22,23,43
863,2015-08-23,24,16,7,40
865,2015-08-29,8,12,20,20
866,2015-08-02,6,20,0,26
868,2015-08-31,130,350,17,480
869,2015-08-31,270,150,8,420
870,2015-08-14,19,19,5,38
871,2015-08-02,2,1,3,3
872,2015-08-09,101,110,15,211
873,2015-08-01,2,2,4,4
874,2015-08-09,7,8,23,15
875,2015-08-08,50,35,8,85
876,2015-08-11,57,51,12,108
877,2015-08-12,44,50,21,94
878,2015-08-12,42,46,13,88
879,2015-08-31,28,20,11,48
880,2015-08-23,98,57,15,155
881,2015-08-03,2,3,1,5
882,2015-08-08,46,63,18,109
883,2015-08-22,78,99,13,177
884,2015-08-04,126,51,6,177
885,2015-08-31,15,11,5,26
886,2015-08-26,174,109,9,283
887,2015-08-09,52,34,19,86
888,2015-08-15,32,35,9,67
890,2015-08-08,39,15,21,54
891,2015-08-19,53,51,11,104
892,2015-08-06,75,92,15,167
893,2015-08-28,19,10,5,29
894,2015-08-31,29,51,15,80
895,2015-08-04,46,45,11,91
896,2015-08-14,19,53,15,72
897,2015-08-11,19,23,23,42
898,2015-08-30,57,41,11,98
899,2015-08-16,11,9,0,20
900,2015-08-06,56,40,12,96
901,2015-08-30,57,72,16,129
902,2015-08-17,74,71,20,145
903,2015-08-27,46,77,14,123
904,2015-08-24,3,7,1,10
905,2015-08-02,51,55,18,106
906,2015-08-12,64,93,20,157
907,2015-08-10,272,124,7,396
908,2015-08-04,7,7,0,14
909,2015-08-18,100,52,6,152
910,2015-08-25,12,19,23,31
911,2015-08-31,7,11,23,18
912,2015-08-11,95,50,6,145
913,2015-08-14,84,199,17,283
915,2015-08-21,19,32,23,51
916,2015-08-13,77,66,10,143
918,2015-08-13,180,495,17,675
919,2015-08-13,392,221,8,613
920,2015-08-06,163,109,9,272
921,2015-08-14,26,39,12,65
922,2015-08-16,82,94,17,176
923,2015-08-16,7,1,4,8
924,2015-08-06,57,39,21,96
925,2015-08-25,108,47,6,155
926,2015-08-18,59,46,11,105
927,2015-08-24,29,15,5,44
928,2015-08-04,86,93,20,179
929,2015-08-25,112,62,10,174
930,2015-08-18,66,100,15,166
931,2015-08-16,3,3,5,6
932,2015-08-11,30,24,5,54
933,2015-08-17,23,18,22,41
934,2015-08-19,53,88,20,141
935,2015-08-11,422,206,8,628
936,2015-08-17,320,132,7,452
937,2015-08-21,50,56,11,106
939,2015-08-27,123,230,16,353
940,2015-08-17,59,86,15,145
941,2015-08-11,171,111,9,282
942,2015-08-09,54,34,8,88
943,2015-08-14,159,81,7,240
944,2015-08-07,142,263,16,405
945,2015-08-04,79,89,15,168
946,2015-08-02,16,22,21,38
947,2015-08-29,4,4,6,8
948,2015-08-12,63,48,11,111
949,2015-08-14,3,6,1,9
950,2015-08-23,63,69,18,132
951,2015-08-12,5,5,1,10
952,2015-08-17,25,12,23,37
953,2015-08-27,174,104,9,278
954,2015-08-04,4,7,4,11
955,2015-08-21,235,106,7,341
956,2015-08-05,175,501,17,676
957,2015-08-24,354,180,8,534
958,2015-08-29,31,21,10,52
959,2015-08-29,6,15,0,21
960,2015-08-18,52,49,21,101
961,2015-08-19,82,123,15,205
962,2015-08-27,222,449,17,671
964,2015-08-03,174,518,17,692
965,2015-08-18,218,486,17,704
966,2015-08-21,61,59,13,120
967,2015-08-18,30,34,22,64
968,2015-08-18,406,208,8,614
969,2015-08-08,84,54,11,138
970,2015-08-10,52,53,13,105
971,2015-08-16,62,52,19,114
972,2015-08-24,15,19,23,34
973,2015-08-18,53,45,13,98
974,2015-08-22,79,69,12,148
976,2015-08-18,323,134,7,457
977,2015-08-22,148,42,10,190
978,2015-08-20,101,54,6,155
979,2015-08-10,304,148,8,452
980,2015-08-21,55,36,10,91
981,2015-08-01,94,69,10,163
983,2015-08-30,80,43,12,123
985,2015-08-15,90,63,15,153
986,2015-08-01,28,25,20,53
988,2015-08-07,99,120,15,219
989,2015-08-09,56,60,9,116
991,2015-08-09,11,1,5,12
992,2015-08-16,153,100,13,253
993,2015-08-03,289,119,7,408
994,2015-08-08,8,4,5,12
995,2015-08-14,43,90,16,133
996,2015-08-05,117,62,6,179
997,2015-08-05,44,60,14,104
998,2015-08-15,9,25,6,34
999,2015-08-16,110,92,12,202
